"lang"
{
"Language"	"ukrainian"
"Tokens"
{
"CP_Instructions_Title"	"ЗАХОПЛЮЙТЕ ТОЧКИ, АБИ ЗДОБУВАТИ ОЧКИ"
"[english]CP_Instructions_Title"	"CAPTURE POINTS TO GAIN TEAM POINTS"
"CP_Objective"	"ЗАХОПІТЬ ТОЧКИ НА МАПІ"
"[english]CP_Objective"	"CAPTURE POINTS ON THE MAP"
"CP_Time"	"ЛИШАЄТЬСЯ %value% С"
"[english]CP_Time"	"SECONDS REMAINING %value%"
"CP_AdditionalTime"	"ДОДАНО ДОДАТКОВИЙ ЧАС"
"[english]CP_AdditionalTime"	"ADDITIONAL TIME HAS BEEN ADDED"
"CP_Expired"	"ЧАС ВИЙШОВ"
"[english]CP_Expired"	"TIME HAS EXPIRED"
"CP1"	"1"
"[english]CP1"	"1"
"CP2"	"2"
"[english]CP2"	"2"
"CP3"	"3"
"[english]CP3"	"3"
"CP4"	"4"
"[english]CP4"	"4"
"CP5"	"5"
"[english]CP5"	"5"
"CP_Radiant"	"СЯЙВО"
"[english]CP_Radiant"	"RADIANT"
"CP_Dire"	"ПІТЬМА"
"[english]CP_Dire"	"DIRE"
"CP_Neutral"	"НЕЙТРАЛЬНИЙ"
"[english]CP_Neutral"	"NEUTRAL"
"Radiant_Base"	"БАЗА СЯЙВА"
"[english]Radiant_Base"	"RADIANT BASE"
"Dire_Base"	"БАЗА ПІТЬМИ"
"[english]Dire_Base"	"DIRE BASE"
"DOTA_Tooltip_ability_item_bag_of_gold"	"100 золота"
"[english]DOTA_Tooltip_ability_item_bag_of_gold"	"100 Gold"
"DOTA_Tooltip_ability_item_fountain_potion"	"Зілля омолодження"
"[english]DOTA_Tooltip_ability_item_fountain_potion"	"Rejuvenation Potion"
"DOTA_Tooltip_ability_item_mango_juice"	"Сік манго"
"[english]DOTA_Tooltip_ability_item_mango_juice"	"Mango Juice"
"DOTA_Tooltip_ability_item_halloween_candy"	"Цукерка (300 золота)"
"[english]DOTA_Tooltip_ability_item_halloween_candy"	"Candy (300 Gold)"
"DOTA_Tooltip_modifier_get_xp_global"	"Загальний досвід"
"[english]DOTA_Tooltip_modifier_get_xp_global"	"Global Experience"
"DOTA_Tooltip_modifier_invis_revealed"	"Істинний зір"
"[english]DOTA_Tooltip_modifier_invis_revealed"	"True Sight"
"DOTA_Tooltip_ability_item_waypoint_entrance_radiant"	"Вхід до телепорту Сяйва"
"[english]DOTA_Tooltip_ability_item_waypoint_entrance_radiant"	"Radiant Waypoint Entrance"
"DOTA_Tooltip_ability_item_waypoint_exit_radiant"	"Вихід з телепорту Сяйва"
"[english]DOTA_Tooltip_ability_item_waypoint_exit_radiant"	"Radiant Waypoint Exit"
"DOTA_Tooltip_ability_item_button_pendulum_radiant"	"Кнопка маятника Сяйва"
"[english]DOTA_Tooltip_ability_item_button_pendulum_radiant"	"Radiant Pendulum Button"
"DOTA_Tooltip_ability_item_button_firetrap_radiant"	"Кнопка вогняної пастки Сяйва"
"[english]DOTA_Tooltip_ability_item_button_firetrap_radiant"	"Radiant Fire Trap Button"
"DOTA_Tooltip_ability_item_button_venomtrap_radiant"	"Кнопка отруйної пастки Сяйва"
"[english]DOTA_Tooltip_ability_item_button_venomtrap_radiant"	"Radiant Venom Trap Button"
"DOTA_Tooltip_ability_item_waypoint_entrance_dire"	"Вхід до телепорту Пітьми"
"[english]DOTA_Tooltip_ability_item_waypoint_entrance_dire"	"Dire Waypoint Entrance"
"DOTA_Tooltip_ability_item_waypoint_exit_dire"	"Вихід з телепорту Пітьми"
"[english]DOTA_Tooltip_ability_item_waypoint_exit_dire"	"Dire Waypoint Exit"
"DOTA_Tooltip_ability_item_button_pendulum_dire"	"Кнопка маятника Пітьми"
"[english]DOTA_Tooltip_ability_item_button_pendulum_dire"	"Dire Pendulum Button"
"DOTA_Tooltip_ability_item_button_firetrap_dire"	"Кнопка вогняної пастки Пітьми"
"[english]DOTA_Tooltip_ability_item_button_firetrap_dire"	"Dire Fire Trap Button"
"DOTA_Tooltip_ability_item_button_venomtrap_dire"	"Кнопка отруйної пастки Пітьми"
"[english]DOTA_Tooltip_ability_item_button_venomtrap_dire"	"Dire Venom Trap Button"
"DOTA_Tooltip_modifier_fountain_aura_effect_lua"	"Зцілення від фонтану"
"[english]DOTA_Tooltip_modifier_fountain_aura_effect_lua"	"Fountain Healing"
"DOTA_Tooltip_modifier_fountain_aura_effect_lua_Description"	"Відновлює здоров’я і ману"
"[english]DOTA_Tooltip_modifier_fountain_aura_effect_lua_Description"	"Regenerating Health and Mana"
"DOTA_Tooltip_modifier_item_greater_salve"	"Дає здоров’я"
"[english]DOTA_Tooltip_modifier_item_greater_salve"	"Gaining Health"
"DOTA_Tooltip_modifier_item_greater_clarity"	"Дає ману"
"[english]DOTA_Tooltip_modifier_item_greater_clarity"	"Gaining Mana"
"npc_dota_creep_radiant_golem"	"Велетень Сяйва"
"[english]npc_dota_creep_radiant_golem"	"Radiant Behemoth"
"npc_dota_creep_dire_golem"	"Велетень Пітьми"
"[english]npc_dota_creep_dire_golem"	"Dire Behemoth"
"npc_dota_creep_radiant_hulk"	"Велетень Сяйва"
"[english]npc_dota_creep_radiant_hulk"	"Radiant Behemoth"
"npc_dota_creep_dire_hulk"	"Велетень Пітьми"
"[english]npc_dota_creep_dire_hulk"	"Dire Behemoth"
"npc_dota_spike_trap_ward"	"Пастка-вістря"
"[english]npc_dota_spike_trap_ward"	"The Spike Trap"
"npc_dota_pendulum_trap_ward"	"Пастка-маятник"
"[english]npc_dota_pendulum_trap_ward"	"The Pendulum Trap"
"npc_dota_fire_trap_ward"	"Вогняна пастка"
"[english]npc_dota_fire_trap_ward"	"The Fire Trap"
"npc_dota_venom_trap_ward"	"Отруйна пастка"
"[english]npc_dota_venom_trap_ward"	"The Venom Trap"
"DOTA_Tooltip_modifier_fountain_glyph"	"Гліф фортифікації"
"[english]DOTA_Tooltip_modifier_fountain_glyph"	"Glyph of Fortification"
"DOTA_Tooltip_modifier_fountain_glyph_Description"	"Усі точки тимчасово заблоковані. Командні очки не нараховуються під час фортифікації."
"[english]DOTA_Tooltip_modifier_fountain_glyph_Description"	"All points are temporarily unable to be captured.  Team points will not accumulate while glyph is activated."
"DOTA_Hotkeys_Tooltip_ActivateGlyph"	"Активує гліф фортифікації, що заморожує усі контрольні точки та командні очки на 10 секунд."
"[english]DOTA_Hotkeys_Tooltip_ActivateGlyph"	"Activates the Glyph of Fortification to make all capture points as well as team points frozen for 10 seconds."
"DOTA_Chat_GlyphUsedGood"	"Сяйво фортифікувало усі контрольні точки."
"[english]DOTA_Chat_GlyphUsedGood"	"Radiant has fortified all capture points."
"DOTA_Chat_GlyphUsedBad"	"Пітьма фортифікувала усі контрольні точки."
"[english]DOTA_Chat_GlyphUsedBad"	"Dire has fortified all capture points."
"DOTA_Tooltip_ability_fountain_glyph"	"Гліф фортифікації"
"[english]DOTA_Tooltip_ability_fountain_glyph"	"Glyph of Fortification"
"DOTA_Tooltip_ability_fountain_glyph_Description"	"Усі захоплені точки тимчасово заблоковані. Командні очки не нараховуються під час фортифікації. Нейтральні точки не фортифікуються."
"[english]DOTA_Tooltip_ability_fountain_glyph_Description"	"All owned points are temporarily unable to be captured.  Team points will not accumulate while glyph is activated.  Neutral points can not be fortified."
"npc_dota_hero_legion_commander"	"Legion Commander (модифіковано)"
"[english]npc_dota_hero_legion_commander"	"Legion Commander (Modified)"
"npc_dota_hero_necrolyte"	"Necrophos (модифіковано)"
"[english]npc_dota_hero_necrolyte"	"Necrophos (Modified)"
"npc_dota_hero_pudge"	"Pudge (модифіковано)"
"[english]npc_dota_hero_pudge"	"Pudge (Modified)"
"npc_dota_hero_silencer"	"Silencer (модифіковано)"
"[english]npc_dota_hero_silencer"	"Silencer (Modified)"
"npc_dota_hero_sniper"	"Sniper (модифіковано)"
"[english]npc_dota_hero_sniper"	"Sniper (Modified)"
"DOTA_Tooltip_modifier_pudge_flesh_heap_Description"	"Опір заклинанням підвищений на %dMODIFIER_PROPERTY_MAGICAL_RESISTANCE_BONUS%%%, сила підвищена на %0fMODIFIER_PROPERTY_STATS_STRENGTH_BONUS%.\n\n<font color='#70EA72'>Здібність ослаблена, а також зменшено радіус отримання снарядів.</font>"
"[english]DOTA_Tooltip_modifier_pudge_flesh_heap_Description"	"Gives Pudge %dMODIFIER_PROPERTY_MAGICAL_RESISTANCE_BONUS%%% additional resistance to spells and a bonus %0fMODIFIER_PROPERTY_STATS_STRENGTH_BONUS% strength.  \n\n<font color='#70EA72'>Flesh Heap magic resistance, strength bonus, and range is reduced in Colosseum.</font>"
"DOTA_Tooltip_ability_pudge_flesh_heap_flesh_heap_magic_resist"	"<font color='#70EA72'>ОПІР МАГІЇ:</font>"
"[english]DOTA_Tooltip_ability_pudge_flesh_heap_flesh_heap_magic_resist"	"<font color='#70EA72'>MAGIC RESISTANCE:</font>"
"DOTA_Tooltip_ability_pudge_flesh_heap_flesh_heap_strength_buff_amount"	"<font color='#70EA72'>ДОД. СИЛА:</font>"
"[english]DOTA_Tooltip_ability_pudge_flesh_heap_flesh_heap_strength_buff_amount"	"<font color='#70EA72'>STRENGTH BONUS:</font>"
"DOTA_Tooltip_ability_pudge_flesh_heap_flesh_heap_range"	"<font color='#70EA72'>ДАЛЬНІСТЬ:</font>"
"[english]DOTA_Tooltip_ability_pudge_flesh_heap_flesh_heap_range"	"<font color='#70EA72'>RANGE:</font>"
"DOTA_Tooltip_ability_pudge_flesh_heap_Description"	"Пудж підвищує опір магічній шкоді й отримує додаткову силу, коли вбиває ворога або ворог гине неподалік. Здібність починає накопичувати заряди ще до того, як буде вивчена, однак починає діяти лише після активації.\n\n<font color='#70EA72'>В примарному колізеї опір магії, додаткова сила та дальність були зменшені.</font>"
"[english]DOTA_Tooltip_ability_pudge_flesh_heap_Description"	"Gives Pudge resistance to magic damage, as well as bonus strength that increases each time Pudge kills an enemy Hero or it dies in his vicinity.  Flesh Heap is retroactive, meaning it can gain charges before it is skilled, which then become active.\n\n<font color='#70EA72'>Flesh Heap magic resistance, strength bonus, and range is reduced in Colosseum.</font>"
"DOTA_Tooltip_modifier_legion_commander_duel_damage_boost_Description"	"Шкоду посилено від переможних дуелей. .\n\n<font color='#70EA72'>Додаткову шкоду зменшено.</font>"
"[english]DOTA_Tooltip_modifier_legion_commander_duel_damage_boost_Description"	"Gaining bonus damage permanently from won duels.\n\n<font color='#70EA72'>Bonus damage is reduced in Colosseum.</font>"
"DOTA_Tooltip_ability_legion_commander_duel_Description"	"Командувачка та цільовий ворожий герой вступають у нетривалу сутичку, під час якої атакують один одного і не можуть користуватися здібностями та предметами. Якщо один із героїв гине під час сутички, переможець дуелі отримує постійне посилення до своєї шкоди.\n\nПокращується зі Скіпетром Аґаніма. \n\n<font color='#70EA72'>Додаткову шкоду зменшено.</font>"
"[english]DOTA_Tooltip_ability_legion_commander_duel_Description"	"Legion Commander and the target enemy hero are forced to attack each other for a short duration.  Neither hero can use items or abilities.  If either hero dies during the duration, the hero winning the Duel gains permanent bonus damage.\n\nUpgradable by Aghanim's Scepter.\n\n<font color='#70EA72'>Bonus damage is reduced in Colosseum.</font>"
"DOTA_Tooltip_ability_legion_commander_duel_reward_damage"	"<font color='#70EA72'>ДОД. ШКОДА:</font>"
"[english]DOTA_Tooltip_ability_legion_commander_duel_reward_damage"	"<font color='#70EA72'>BONUS DAMAGE:</font>"
"DOTA_Tooltip_ability_silencer_glaives_of_wisdom_Description"	"Знемовлювач зачаровує свої глефи власною мудрістю та завдає додаткової шкоди залежно від свого інтелекту. \n\nГлефи мудрості мають унікальний модифікатор атаки, який не складається з іншими унікальними модифікаторами атаки.\n\n<font color='#70EA72'>У примарному колізеї зменшена додаткова шкода та дальність атаки.</font>"
"[english]DOTA_Tooltip_ability_silencer_glaives_of_wisdom_Description"	"Silencer enchants his glaives with his wisdom, dealing additional damage based on his Intelligence. \n\nGlaives of Wisdom is a Unique Attack Modifier, and does not stack with other Unique Attack Modifiers.\n\n<font color='#70EA72'>Glaives of Wisdom intelligence percentage and range is reduced in Colosseum.</font>"
"DOTA_Tooltip_ability_silencer_glaives_of_wisdom_intellect_damage_pct"	"<font color='#70EA72'>ОЧ. ІНТ. НА ОД. ШКОДИ:</font>"
"[english]DOTA_Tooltip_ability_silencer_glaives_of_wisdom_intellect_damage_pct"	"<font color='#70EA72'>INT TO DAMAGE:</font>"
"DOTA_Tooltip_ability_necrolyte_reapers_scythe_Description"	"<font color='#F2A93E'>Коса женця</font>\nПриголомшує обраного ворожого героя, потім завдає шкоди, що залежить від кількості відсутнього у ворога здоров’я.\n\n<font color='#70EA72'>У Примарному Колізеї герої, вбиті здібністю, відроджуються на 20 секунд довше.</font>\n\nКожне вбивство під дією цього ефекту зараховується Некрофосові. \n\nПокращується зі Скіпетром Аганіма."
"[english]DOTA_Tooltip_ability_necrolyte_reapers_scythe_Description"	"Stuns the target enemy hero, then deals damage based on how much life it is missing.\n\n<font color='#70EA72'>In Colosseum, heroes killed by Reaper's Scythe will have 20 seconds added to their respawn timer.</font>\n\nAny kill under this effect is credited to Necrophos.\n\nUpgradable by Aghanim's Scepter."
"DOTA_Tooltip_ability_necrolyte_reapers_scythe_respawn_constant"	"<font color='#70EA72'>ШТРАФ ДО ЧАСУ ВІДРОДЖЕННЯ:</font>"
"[english]DOTA_Tooltip_ability_necrolyte_reapers_scythe_respawn_constant"	"<font color='#70EA72'>ADDED RESPAWN TIME:</font>"
"DOTA_Tooltip_ability_sniper_take_aim_Description"	"Збільшує дальність атаки снайперської рушниці.\n\n<font color='#70EA72'>Дальність атаки зменшено.</font>"
"[english]DOTA_Tooltip_ability_sniper_take_aim_Description"	"Extends the attack range of Sniper's rifle.\n\n<font color='#70EA72'>Attack range has been reduced in Colosseum.</font>"
"DOTA_Tooltip_ability_sniper_take_aim_bonus_attack_range"	"<font color='#70EA72'>ДОД. ДАЛЬНІСТЬ:</font>"
"[english]DOTA_Tooltip_ability_sniper_take_aim_bonus_attack_range"	"<font color='#70EA72'>BONUS RANGE:</font>"
"npc_dota_hero_tinker"	"Tinker (модифіковано)"
"[english]npc_dota_hero_tinker"	"Tinker (Modified)"
"DOTA_Tooltip_ability_tinker_heat_seeking_missile_Description"	"<font color='#70EA72'>Запускає пару ракет у найближчих видимих ворожих героїв у радіусі 1250 одиниць.</font>\n\nЧисло цілей подвоюється зі Скіпетром Аганіма."
"[english]DOTA_Tooltip_ability_tinker_heat_seeking_missile_Description"	"<font color='#70EA72'>Launches a pair of rockets at the nearest visible enemy heroes within 1250 range in Colosseum.</font>\n\nThe number of missile targets is doubled with Aghanim's Scepter."
"DOTA_Tooltip_ability_item_button_sawblade_radiant"	"Кнопка пилки Сяйва"
"[english]DOTA_Tooltip_ability_item_button_sawblade_radiant"	"Radiant Sawblade Button"
"DOTA_Tooltip_ability_item_button_sawblade_dire"	"Кнопка пилки Пітьми"
"[english]DOTA_Tooltip_ability_item_button_sawblade_dire"	"Dire Sawblade Button"
"npc_dota_sawblade_trap_ward"	"Пастка-пилка"
"[english]npc_dota_sawblade_trap_ward"	"The Sawblade Trap"
"DOTA_Tooltip_ability_item_health_treat"	"Здоров’я"
"[english]DOTA_Tooltip_ability_item_health_treat"	"Health Treat"
"DOTA_Tooltip_ability_item_mana_treat"	"Мана"
"[english]DOTA_Tooltip_ability_item_mana_treat"	"Mana Treat"
"DOTA_Tooltip_ability_item_button_boulder_radiant"	"Кнопка каменя Сяйва"
"[english]DOTA_Tooltip_ability_item_button_boulder_radiant"	"Radiant Boulder Button"
"DOTA_Tooltip_ability_item_button_boulder_dire"	"Кнопка каменя Пітьми"
"[english]DOTA_Tooltip_ability_item_button_boulder_dire"	"Dire Boulder Button"
}
}
