"dota"
{
"Radiant_Team"	"ILUMINADOS"
"[english]Radiant_Team"	"RADIANT"
"Dire_Team"	"TEMIDOS"
"[english]Dire_Team"	"DIRE"
"Achievement_First"	"MARCARAM 1.000 PONTOS!"
"[english]Achievement_First"	"ACHIEVED 1000 POINTS!"
"Achievement_Second"	"MARCARAM 2.000 PONTOS!"
"[english]Achievement_Second"	"ACHIEVED 2000 POINTS!"
"Achievement_Third"	"MARCARAM 3.000 PONTOS!"
"[english]Achievement_Third"	"ACHIEVED 3000 POINTS!"
"Achievement_Fourth"	"MARCARAM 4.000 PONTOS!"
"[english]Achievement_Fourth"	"ACHIEVED 4000 POINTS!"
"Achievement_Fifth"	"FALTA MENOS DE"
"[english]Achievement_Fifth"	"NEEDS LESS THAN"
"Reward_Fifth_Radiant"	"100 PONTOS PARA VENCER!"
"[english]Reward_Fifth_Radiant"	"100 POINTS TO WIN!"
"Reward_Fifth_Dire"	"100 PONTOS PARA VENCER!"
"[english]Reward_Fifth_Dire"	"100 POINTS TO WIN!"
"Radiant_Winning"	"PONTOS DOS ILUMINADOS"
"[english]Radiant_Winning"	"RADIANT SCORE"
"Dire_Winning"	"PONTOS DOS TEMIDOS"
"[english]Dire_Winning"	"DIRE SCORE"
"Radiant_Waypoint"	"ATALHO DOS ILUMINADOS ATIVADO"
"[english]Radiant_Waypoint"	"RADIANT WAYPOINT NOW ACTIVE"
"Dire_Waypoint"	"ATALHO DOS TEMIDOS ATIVADO"
"[english]Dire_Waypoint"	"DIRE WAYPOINT NOW ACTIVE"
"Waypoint_Active"	"ATALHOS ATIVADOS"
"[english]Waypoint_Active"	"WAYPOINTS NOW ACTIVE"
"CP1"	"1"
"[english]CP1"	"1"
"CP2"	"2"
"[english]CP2"	"2"
"CP3"	"3"
"[english]CP3"	"3"
"CP4"	"4"
"[english]CP4"	"4"
"CP5"	"5"
"[english]CP5"	"5"
"CP_Radiant"	"ILUMINADOS"
"[english]CP_Radiant"	"RADIANT"
"CP_Dire"	"TEMIDOS"
"[english]CP_Dire"	"DIRE"
"CP_Neutral"	"NEUTRO"
"[english]CP_Neutral"	"NEUTRAL"
"Radiant_Base"	"BASE DOS ILUMINADOS"
"[english]Radiant_Base"	"RADIANT BASE"
"Dire_Base"	"BASE DOS TEMIDOS"
"[english]Dire_Base"	"DIRE BASE"
"DOTA_Tooltip_ability_item_bag_of_gold"	"Ouro"
"[english]DOTA_Tooltip_ability_item_bag_of_gold"	"Gold"
"DOTA_Tooltip_ability_item_fountain_potion"	"Rejuvenescimento"
"[english]DOTA_Tooltip_ability_item_fountain_potion"	"Rejuvenation"
"WP_Radiant"	"ATALHO DOS ILUMINADOS"
"[english]WP_Radiant"	"RADIANT WAYPOINT"
"WP_Dire"	"ATALHO DOS TEMIDOS"
"[english]WP_Dire"	"DIRE WAYPOINT"
"ConquestTeamPoints"	"Pontos"
"[english]ConquestTeamPoints"	"Points"
"conquest_game_info_header_objective"	"Objetivo:"
"[english]conquest_game_info_header_objective"	"Objective:"
"conquest_game_info_header_how_to_play"	"Como jogar:"
"[english]conquest_game_info_header_how_to_play"	"How To Play:"
"conquest_game_info_spike_traps"	"Armadilhas de Espinhos são ativadas passando sobre elas."
"[english]conquest_game_info_spike_traps"	"Spike Traps are activated by stepping on them."
"conquest_game_info_pendulum"	"O Pêndulo e as Armadilhas de Espinhos causarão dano a qualquer herói atingido, independentemente de quem ativou."
"[english]conquest_game_info_pendulum"	"The Pendulum and Spike Traps will damage all heroes regardless of who activated them."
"conquest_game_info_fire_traps_2"	"Armadilhas de Fogo e Armadilhas Venenosas só causam dano a inimigos do herói que as ativar."
"[english]conquest_game_info_fire_traps_2"	"Fire Traps and Venom Traps only damage enemies of the hero that activated them."
"conquest_game_info_tips_header"	"Dicas:"
"[english]conquest_game_info_tips_header"	"Tips:"
}
