"dota"
{
"Radiant_Team"	"RADIANT"
"[english]Radiant_Team"	"RADIANT"
"Dire_Team"	"DIRE"
"[english]Dire_Team"	"DIRE"
"Achievement_First"	"เก็บได้ 1000 แต้มแล้ว!"
"[english]Achievement_First"	"ACHIEVED 1000 POINTS!"
"Achievement_Second"	"เก็บได้ 2000 แต้มแล้ว!"
"[english]Achievement_Second"	"ACHIEVED 2000 POINTS!"
"Achievement_Third"	"เก็บได้ 3000 แต้มแล้ว!"
"[english]Achievement_Third"	"ACHIEVED 3000 POINTS!"
"Achievement_Fourth"	"เก็บได้ 4000 แต้มแล้ว!"
"[english]Achievement_Fourth"	"ACHIEVED 4000 POINTS!"
"Achievement_Fifth"	"ต้องเก็บอีกไม่ถึง"
"[english]Achievement_Fifth"	"NEEDS LESS THAN"
"Reward_Fifth_Radiant"	"100 แต้มก็จะชนะ!"
"[english]Reward_Fifth_Radiant"	"100 POINTS TO WIN!"
"Reward_Fifth_Dire"	"100 แต้มก็จะชนะ!"
"[english]Reward_Fifth_Dire"	"100 POINTS TO WIN!"
"Radiant_Winning"	"แต้มฝั่ง RADIANT"
"[english]Radiant_Winning"	"RADIANT SCORE"
"Dire_Winning"	"แต้มฝั่ง DIRE"
"[english]Dire_Winning"	"DIRE SCORE"
"Radiant_Waypoint"	"จุดเคลื่อนย้ายฝั่ง RADIANT ทำงานแล้ว"
"[english]Radiant_Waypoint"	"RADIANT WAYPOINT NOW ACTIVE"
"Dire_Waypoint"	"จุดเคลื่อนย้ายฝั่ง DIRE ทำงานแล้ว"
"[english]Dire_Waypoint"	"DIRE WAYPOINT NOW ACTIVE"
"Waypoint_Active"	"จุดเคลื่อนย้ายทำงานแล้ว"
"[english]Waypoint_Active"	"WAYPOINTS NOW ACTIVE"
"CP1"	"1"
"[english]CP1"	"1"
"CP2"	"2"
"[english]CP2"	"2"
"CP3"	"3"
"[english]CP3"	"3"
"CP4"	"4"
"[english]CP4"	"4"
"CP5"	"5"
"[english]CP5"	"5"
"CP_Radiant"	"RADIANT"
"[english]CP_Radiant"	"RADIANT"
"CP_Dire"	"DIRE"
"[english]CP_Dire"	"DIRE"
"CP_Neutral"	"NEUTRAL"
"[english]CP_Neutral"	"NEUTRAL"
"Radiant_Base"	"ฐานฝั่ง RADIANT"
"[english]Radiant_Base"	"RADIANT BASE"
"Dire_Base"	"ฐานฝั่ง DIRE"
"[english]Dire_Base"	"DIRE BASE"
"DOTA_Tooltip_ability_item_bag_of_gold"	"โกลด์"
"[english]DOTA_Tooltip_ability_item_bag_of_gold"	"Gold"
"DOTA_Tooltip_ability_item_fountain_potion"	"ยาฟื้นฟู"
"[english]DOTA_Tooltip_ability_item_fountain_potion"	"Rejuvenation"
"WP_Radiant"	"จุดเคลื่อนย้ายฝั่ง RADIANT"
"[english]WP_Radiant"	"RADIANT WAYPOINT"
"WP_Dire"	"จุดเคลื่อนย้ายฝั่ง DIRE"
"[english]WP_Dire"	"DIRE WAYPOINT"
"ConquestTeamPoints"	"แต้ม"
"[english]ConquestTeamPoints"	"Points"
"conquest_game_info_header_objective"	"เป้าหมายภารกิจ:"
"[english]conquest_game_info_header_objective"	"Objective:"
"conquest_game_info_header_how_to_play"	"วิธีเล่น:"
"[english]conquest_game_info_header_how_to_play"	"How To Play:"
"conquest_game_info_spike_traps"	"กับดักหนามจะสามารถทำงานได้ด้วยการเหยียบด้านบน"
"[english]conquest_game_info_spike_traps"	"Spike Traps are activated by stepping on them."
"conquest_game_info_pendulum"	"ลูกตุ้มขวานและกับดักหนามจะสร้างความเสียหายกับฮีโร่ทุกตัวที่โดน รวมทั้งผู้ที่เปิดใช้งาน"
"[english]conquest_game_info_pendulum"	"The Pendulum and Spike Traps will damage all heroes regardless of who activated them."
"conquest_game_info_fire_traps_2"	"กับดักไฟและกับดักพิษจะสร้างความเสียหายกับศัตรูของฮีโร่ที่เปิดใช้งานเท่านั้น"
"[english]conquest_game_info_fire_traps_2"	"Fire Traps and Venom Traps only damage enemies of the hero that activated them."
"conquest_game_info_tips_header"	"เคล็ดลับ:"
"[english]conquest_game_info_tips_header"	"Tips:"
}
