"dota"
{
"Radiant_Team"	"RADIANT"
"[english]Radiant_Team"	"RADIANT"
"Dire_Team"	"DIRE"
"[english]Dire_Team"	"DIRE"
"Achievement_First"	"ĐẠT 1000 ĐIỂM!"
"[english]Achievement_First"	"ACHIEVED 1000 POINTS!"
"Achievement_Second"	"ĐẠT 2000 ĐIỂM!"
"[english]Achievement_Second"	"ACHIEVED 2000 POINTS!"
"Achievement_Third"	"ĐẠT ĐƯỢC 3000 ĐIỂM!"
"[english]Achievement_Third"	"ACHIEVED 3000 POINTS!"
"Achievement_Fourth"	"ĐẠT ĐƯỢC 4000 ĐIỂM!"
"[english]Achievement_Fourth"	"ACHIEVED 4000 POINTS!"
"Achievement_Fifth"	"CẦN ÍT HƠN"
"[english]Achievement_Fifth"	"NEEDS LESS THAN"
"Reward_Fifth_Radiant"	"100 ĐIỂM NỮA LÀ THẮNG!"
"[english]Reward_Fifth_Radiant"	"100 POINTS TO WIN!"
"Reward_Fifth_Dire"	"100 ĐIỂM ĐỂ THẮNG!"
"[english]Reward_Fifth_Dire"	"100 POINTS TO WIN!"
"Radiant_Winning"	"ĐIỂM ĐỘI RADIANT"
"[english]Radiant_Winning"	"RADIANT SCORE"
"Dire_Winning"	"ĐIỂM ĐỘI DIRE"
"[english]Dire_Winning"	"DIRE SCORE"
"CP1"	"1"
"[english]CP1"	"1"
"CP2"	"2"
"[english]CP2"	"2"
"CP3"	"3"
"[english]CP3"	"3"
"CP4"	"4"
"[english]CP4"	"4"
"CP5"	"5"
"[english]CP5"	"5"
"CP_Radiant"	"RADIANT"
"[english]CP_Radiant"	"RADIANT"
"CP_Dire"	"DIRE"
"[english]CP_Dire"	"DIRE"
"CP_Neutral"	"TRUNG LẬP"
"[english]CP_Neutral"	"NEUTRAL"
"Radiant_Base"	"CĂN CỨ PHE RADIANT"
"[english]Radiant_Base"	"RADIANT BASE"
"Dire_Base"	"CĂN CỨ PHE DIRE
"
"[english]Dire_Base"	"DIRE BASE"
"DOTA_Tooltip_ability_item_bag_of_gold"	"Vàng"
"[english]DOTA_Tooltip_ability_item_bag_of_gold"	"Gold"
"DOTA_Tooltip_ability_item_fountain_potion"	"Hồi phục"
"[english]DOTA_Tooltip_ability_item_fountain_potion"	"Rejuvenation"
"ConquestTeamPoints"	"Điểm"
"[english]ConquestTeamPoints"	"Points"
"conquest_game_info_header_objective"	"Mục tiêu:"
"[english]conquest_game_info_header_objective"	"Objective:"
"conquest_game_info_header_how_to_play"	"Cách chơi:"
"[english]conquest_game_info_header_how_to_play"	"How To Play:"
"conquest_game_info_tips_header"	"Mẹo:"
"[english]conquest_game_info_tips_header"	"Tips:"
}
